22  22  22  22  22  22  22  22  22  22  22  22  22  22  22  22  22  22  22  22  22  22  22  22  22  22  22  22  22  22  22  22  22  22  22  22  22  22  22  22  22  22  22  22 
22  22  22  22  22  22  22  22  22  22  22  22  22  22  22  22  22  22  22  22  22  22  22  22  22  22  22  22  22  22  22  22  22  22  22  22  22  22  22  22  22  22  22  22 
22  22  22  22  22  22  22  22  22  22  22  22  22  22  22  22  22  22  22  22  22  22  22  22  22  22  22  22  22  22  22  22  22  22  22  22  22  22  22  22  22  22  22  22
22  22  22  22  22  22  22  22  22  22  22  22  22  22  22  22  22  22  22  22  22  22  22  22  0   0   0   22  22  22  22  22  22  22  22  22  22  0   0   0   0   0   0   0
22  22  22  22  22  22  0   0   0   0   22  22  22  22  22  22  22  22  22  22  22  22  22  22  0   0   0   22  22  22  22  22  22  22  22  22  0   0   0   0   0   0   0   50
22  22  22  22  22  22  0   150 0   0   22  22  22  22  22  22  22  22  22  22  22  22  22  22  0   0   0   0   0   0   22  22  22  22  22  0   0   22  0   22  0   22  0   22
22  22  22  22  22  22  0   0   0   0   0   22  22  22  22  22  22  22  22  22  22  22  22  22  15  0   0   0   0   0   0   22  22  22  0   0   0   22  33  22  33  22  33  22
22  22  22  22  22  22  22  22  22  0   0   0   22  22  22  22  22  22  22  22  22  22  22  22  22  22  22  22  22  0   0   22  22  22  0   22  22  22  22  22  22  22  22  22
22  22  22  22  22  22  22  22  22  22  0   0   22  22  22  22  22  22  22  22  22  22  22  22  22  22  22  22  22  0   0   22  22  22  0   0   0   0   0   0   22  22  22  22
22  22  22  22  22  22  22  22  22  22  0   0   22  22  22  22  22  22  22  22  22  22  22  22  22  22  22  22  22  0   8   22  22  22  22  0   22  0   0   0   22  22  22  22
22  22  22  22  22  22  22  22  22  22  0   0   22  22  22  22  22  22  22  22  22  22  22  22  22  22  22  22  22  0   0   22  22  22  22  22  22  22  0   0   22  22  22  22
22  22  22  22  22  22  22  22  22  0   0   0   22  22  22  22  22  22  22  22  22  22  22  22  22  22  22  22  22  0   0   22  22  22  22  22  22  22  0   0   22  22  22  22
22  22  22  22  22  22  22  0   0   0   0   0   0   22  22  22  22  22  22  22  22  22  22  22  22  22  22  22  22  10  0   0   0   0   0   0   0   0   0   22  22  22  22  22
22  22  22  22  22  22  0   0   0   22  22  0   0   22  22  22  22  22  22  22  22  22  22  22  22  22  22  22  22  0   0   0   0   0   0   101 0   22  22  22  22  22  22  22
22  22  22  22  22  0   0   0   22  22  22  0   0   0   0   22  22  22  22  22  22  22  22  22  22  22  22  22  22  0   8   22  22  22  22  22  22  22  22  22  22  22  22  22
22  22  22  22  22  50  0   22  22  22  22  22  0   0   0   0   22  22  22  22  22  22  22  22  22  22  22  22  22  0   0   22  22  22  22  22  22  22  22  22  22  22  22  22
22  22  22  22  22  22  22  22  22  22  22  22  0   0   0   0   0   22  22  22  22  22  22  22  22  22  22  22  22  0   0   22  22  22  22  22  22  22  22  22  22  22  22  22
22  22  22  22  22  22  22  22  22  22  22  22  22  22  22  0   0   0   0   22  22  22  22  22  22  22  22  22  22  10  0   22  22  22  22  22  22  22  22  22  22  22  22  22
22  22  22  22  22  22  22  22  22  22  22  22  22  22  22  22  0   0   0   22  22  22  22  22  22  0   0   0   0   0   0   22  22  22  22  22  22  22  22  22  22  22  22  22
22  22  22  22  22  0   0   0   0   0   0   0   0   0   22  22  22  22  0   0   0   0   0   0   0   0   0   0   101 0   0   22  22  22  22  22  22  22  22  22  22  22  22  22
22  22  22  22  22  50  0   0   0   0   0   0   0   0   0   22  22  22  22  0   0   0   0   0   0   22  22  22  22  22  22  22  22  22  22  22  22  22  22  22  22  22  22  22
22  22  22  22  22  22  22  0   0   0   22  0   0   22  22  22  22  0   0   0  0   0   22  22  22  22  22  22  22  22  22  22  22  22  22  22  22  22  22  22  22  22  22  22
22  22  22  22  22  22  22  33  33  33  22  22  0   0   0   0   0   0   0   0  0   22  22  22  22  22  22  22  22  22  22  22  22  22  22  22  22  22  22  22  22  22  22  22
22  22  22  22  22  22  22  33  33  33  22  22  22  0   0   102 0   0   0   22  22  22  22  22  22  22  22  22  22  22  22  22  22  22  22  22  22  22  22  22  22  22  22  22
22  22  22  22  22  22  22  22  22  22  22  22  22  22  22  22  22  22  22  22  22  22  22  22  22  22  22  22  22  22  22  22  22  22  22  22  22  22  22  22  22  22  22  22 
22  22  22  22  22  22  22  22  22  22  22  22  22  22  22  22  22  22  22  22  22  22  22  22  22  22  22  22  22  22  22  22  22  22  22  22  22  22  22  22  22  22  22  22 
22  22  22  22  22  22  22  22  22  22  22  22  22  22  22  22  22  22  22  22  22  22  22  22  22  22  22  22  22  22  22  22  22  22  22  22  22  22  22  22  22  22  22  22 
22  22  22  22  22  22  22  22  22  22  22  22  22  22  22  22  22  22  22  22  22  22  22  22  22  22  22  22  22  22  22  22  22  22  22  22  22  22  22  22  22  22  22  22 
22  22  22  22  22  22  22  22  22  22  22  22  22  22  22  22  22  22  22  22  22  22  22  22  22  22  22  22  22  22  22  22  22  22  22  22  22  22  22  22  22  22  22  22 
22  22  22  22  22  22  22  22  22  22  22  22  22  22  22  22  22  22  22  22  22  22  22  22  22  22  22  22  22  22  22  22  22  22  22  22  22  22  22  22  22  22  22  22 
22  22  22  22  22  22  22  22  22  22  22  22  22  22  22  22  22  22  22  22  22  22  22  22  22  22  22  22  22  22  22  22  22  22  22  22  22  22  22  22  22  22  22  22 
22  22  22  22  22  22  22  22  22  22  22  22  22  22  22  22  22  22  22  22  22  22  22  22  22  22  22  22  22  22  22  22  22  22  22  22  22  22  22  22  22  22  22  22 
