0 0 0 0 0 0 0 0 0 0 0 0 0 0 0 0 0 0 0 0 0 0
0 150 0 0 0 0 0 0 0 0 0 0 0 0 0 0 0 0 0 0 0 0
13 13 13 13 13 14 0 0 0 0 0 0 0 0 0 0 0 0 0 0 0 0
0 0 0 0 0 0 0 0 0 0 50 0 0 0 0 0 0 0 0 0 0 0
0 0 0 0 0 0 0 0 0 0 0 0 0 0 0 0 0 0 0 0 0 0
0 0 0 0 0 0 0 0 0 0 0 0 0 0 0 0 101 0 0 0 0 0
0 0 0 0 0 0 0 0 0 0 0 1 2 2 2 2 2 2 2 2 2 2
0 0 0 0 0 0 8 9 10 0 0 4 11 11 11 11 11 11 11 11 11 11
0 0 0 0 0 0 102 0 0 0 0 4 11 11 11 11 11 11 11 11 11 11
0 0 0 1 2 2 2 2 3 0 0 4 11 11 11 11 11 11 11 11 11 11
15 3 0 4 11 11 11 11 5 0 8 4 11 11 11 11 11 11 11 11 11 11
11 5 0 4 11 11 11 11 5 50 0 4 11 11 11 11 11 11 11 11 11 11
11 6 2 7 11 11 11 11 6 2 2 7 11 11 11 11 11 11 11 11 11 11